  #####
###   #
#.@!  #
### !.#
#.##! #
# # . ##
#! ^!!.#
#   .  #
########
