   #####
####   #
#  #!  ####
# !!      #
#@  #! !# #
### #   # #
 #  ##### #
 #  ..... #
 ##########